###############
#     *    x  #
# # # # # # # #
#     *B      #
# # #*#*# # # #
#    M *      #
# # #*#*# # # #
#    * X*     #
# # # # # # # #
#    R**      #
# # # # # # # #
#   X         #
###############