###############
# *   *    x  #
# # # # # # # #
#     *B      #
# # #*#*# # # #
#    * M      #
#*# #*#*# # # #
#    * S*     #
# # # # # # # #
#    R**      #
# # # # # # # #
#*    X      *#
###############