################
#     *    x   #
# # # # # # #  #
#     *B       #
# # #*#*# # #  #
#    M *       #
# # #*#*# # #  #
#    * x*      #
# # # # # # #  #
#    R**       #
# # # # # # #  #
#              #
################