###############
# *   *    x  #
# # # # # # # #
#     *B      #
# # #*#*# # # #
#    * M      #
#*# #*#*# # # #
#    * x*     #
# # # # # # # #
#    R**      #
# # # # # # # #
#*    x      *#
###############